*N*******
*     * *
* *** * *
* * *   *
* * *** *
* * *   *
*** * * *
*     * *
*******X*
