**N************
*       *     *
* * *** * *** *
* * * * * *   *
* *   * *** * *
* ***** *   * *
* * * * * *** *
* * * *   *   *
*     ***** ***
* *****   * * *
* *     * * * *
*** *****     *
* * *   ***** *
*     *    *  *
************X**